sincronizzazione	../8marzo/post_pref/extraction_corpora/sincronizzazione.tsv
democrazia	../8marzo/post_pref/extraction_corpora/democrazia.tsv
capitalismo	../8marzo/post_pref/extraction_corpora/capitalismo.tsv
corso	../8marzo/post_pref/extraction_corpora/corso.tsv
maturità	../8marzo/post_pref/extraction_corpora/maturità.tsv
università	../8marzo/post_pref/extraction_corpora/università.tsv
volo	../8marzo/post_pref/extraction_corpora/volo.tsv
sessantottini	../8marzo/post_pref/extraction_corpora/sessantottini.tsv
attentati	../8marzo/post_pref/extraction_corpora/attentati.tsv
processamento	../8marzo/post_pref/extraction_corpora/processamento.tsv
sessantottino	../8marzo/post_pref/extraction_corpora/sessantottino.tsv
disastro	../8marzo/post_pref/extraction_corpora/disastro.tsv
Ora	../8marzo/post_pref/extraction_corpora/Ora.tsv
combustore	../8marzo/post_pref/extraction_corpora/combustore.tsv
allargamento	../8marzo/post_pref/extraction_corpora/allargamento.tsv
razionalista	../8marzo/post_pref/extraction_corpora/razionalista.tsv
calamità	../8marzo/post_pref/extraction_corpora/calamità.tsv
acuti	../8marzo/post_pref/extraction_corpora/acuti.tsv
politica	../8marzo/post_pref/extraction_corpora/politica.tsv
esercizio	../8marzo/post_pref/extraction_corpora/esercizio.tsv
adolescenza	../8marzo/post_pref/extraction_corpora/adolescenza.tsv
apocalisse	../8marzo/post_pref/extraction_corpora/apocalisse.tsv
acquisizione	../8marzo/post_pref/extraction_corpora/acquisizione.tsv
visione	../8marzo/post_pref/extraction_corpora/visione.tsv
processore	../8marzo/post_pref/extraction_corpora/processore.tsv
bruciatori	../8marzo/post_pref/extraction_corpora/bruciatori.tsv
minimalismo	../8marzo/post_pref/extraction_corpora/minimalismo.tsv
cristianesimo	../8marzo/post_pref/extraction_corpora/cristianesimo.tsv
industriali	../8marzo/post_pref/extraction_corpora/industriali.tsv
operazione	../8marzo/post_pref/extraction_corpora/operazione.tsv
lavoro	../8marzo/post_pref/extraction_corpora/lavoro.tsv
sbornia	../8marzo/post_pref/extraction_corpora/sbornia.tsv
apertura	../8marzo/post_pref/extraction_corpora/apertura.tsv
formazione	../8marzo/post_pref/extraction_corpora/formazione.tsv
produzioni	../8marzo/post_pref/extraction_corpora/produzioni.tsv
riscaldamento	../8marzo/post_pref/extraction_corpora/riscaldamento.tsv
processo	../8marzo/post_pref/extraction_corpora/processo.tsv
romanticismo	../8marzo/post_pref/extraction_corpora/romanticismo.tsv
bellici	../8marzo/post_pref/extraction_corpora/bellici.tsv
bellico	../8marzo/post_pref/extraction_corpora/bellico.tsv
ictus	../8marzo/post_pref/extraction_corpora/ictus.tsv
adolescenti	../8marzo/post_pref/extraction_corpora/adolescenti.tsv
dittatura	../8marzo/post_pref/extraction_corpora/dittatura.tsv
separazione	../8marzo/post_pref/extraction_corpora/separazione.tsv
donazione	../8marzo/post_pref/extraction_corpora/donazione.tsv
anni	../8marzo/post_pref/extraction_corpora/anni.tsv
riunificazione	../8marzo/post_pref/extraction_corpora/riunificazione.tsv
scudetto	../8marzo/post_pref/extraction_corpora/scudetto.tsv
pensiero	../8marzo/post_pref/extraction_corpora/pensiero.tsv
legge	../8marzo/post_pref/extraction_corpora/legge.tsv
secondaria	../8marzo/post_pref/extraction_corpora/secondaria.tsv
servizio	../8marzo/post_pref/extraction_corpora/servizio.tsv
natale	../8marzo/post_pref/extraction_corpora/natale.tsv
commercializzazione	../8marzo/post_pref/extraction_corpora/commercializzazione.tsv
cena	../8marzo/post_pref/extraction_corpora/cena.tsv
iniezione	../8marzo/post_pref/extraction_corpora/iniezione.tsv
spettacolo	../8marzo/post_pref/extraction_corpora/spettacolo.tsv
feste	../8marzo/post_pref/extraction_corpora/feste.tsv
pillola	../8marzo/post_pref/extraction_corpora/pillola.tsv
congresso	../8marzo/post_pref/extraction_corpora/congresso.tsv
specializzazione	../8marzo/post_pref/extraction_corpora/specializzazione.tsv
esperienza	../8marzo/post_pref/extraction_corpora/esperienza.tsv
berlusconiano	../8marzo/post_pref/extraction_corpora/berlusconiano.tsv
industrialismo	../8marzo/post_pref/extraction_corpora/industrialismo.tsv
liberazione	../8marzo/post_pref/extraction_corpora/liberazione.tsv
sovietica	../8marzo/post_pref/extraction_corpora/sovietica.tsv
rivoluzionario	../8marzo/post_pref/extraction_corpora/rivoluzionario.tsv
acquisto	../8marzo/post_pref/extraction_corpora/acquisto.tsv
gravidanza	../8marzo/post_pref/extraction_corpora/gravidanza.tsv
impianto	../8marzo/post_pref/extraction_corpora/impianto.tsv
matrimonio	../8marzo/post_pref/extraction_corpora/matrimonio.tsv
coma	../8marzo/post_pref/extraction_corpora/coma.tsv
muro	../8marzo/post_pref/extraction_corpora/muro.tsv
macchiaioli	../8marzo/post_pref/extraction_corpora/macchiaioli.tsv
conferenza	../8marzo/post_pref/extraction_corpora/conferenza.tsv
sentenza	../8marzo/post_pref/extraction_corpora/sentenza.tsv
ferragosto	../8marzo/post_pref/extraction_corpora/ferragosto.tsv
acuto	../8marzo/post_pref/extraction_corpora/acuto.tsv
bop	../8marzo/post_pref/extraction_corpora/bop.tsv
contestazione	../8marzo/post_pref/extraction_corpora/contestazione.tsv
docs	../8marzo/post_pref/extraction_corpora/docs.tsv
ermetismo	../8marzo/post_pref/extraction_corpora/ermetismo.tsv
maremoto	../8marzo/post_pref/extraction_corpora/maremoto.tsv
menopausale	../8marzo/post_pref/extraction_corpora/menopausale.tsv
nuke	../8marzo/post_pref/extraction_corpora/nuke.tsv
operatoria	../8marzo/post_pref/extraction_corpora/operatoria.tsv
partito	../8marzo/post_pref/extraction_corpora/partito.tsv
tridentino	../8marzo/post_pref/extraction_corpora/tridentino.tsv
yuppies	../8marzo/post_pref/extraction_corpora/yuppies.tsv
lancio	../8marzo/post_pref/extraction_corpora/lancio.tsv
stampa	../8marzo/post_pref/extraction_corpora/stampa.tsv
rottura	../8marzo/post_pref/extraction_corpora/rottura.tsv
viaggio	../8marzo/post_pref/extraction_corpora/viaggio.tsv
sbronza	../8marzo/post_pref/extraction_corpora/sbronza.tsv
finale	../8marzo/post_pref/extraction_corpora/finale.tsv
garanzia	../8marzo/post_pref/extraction_corpora/garanzia.tsv
cristiani	../8marzo/post_pref/extraction_corpora/cristiani.tsv
unificazione	../8marzo/post_pref/extraction_corpora/unificazione.tsv
invasione	../8marzo/post_pref/extraction_corpora/invasione.tsv
realizzazione	../8marzo/post_pref/extraction_corpora/realizzazione.tsv
festività	../8marzo/post_pref/extraction_corpora/festività.tsv
industrializzazione	../8marzo/post_pref/extraction_corpora/industrializzazione.tsv
tour	../8marzo/post_pref/extraction_corpora/tour.tsv
assunzione	../8marzo/post_pref/extraction_corpora/assunzione.tsv
conversione	../8marzo/post_pref/extraction_corpora/conversione.tsv
degenza	../8marzo/post_pref/extraction_corpora/degenza.tsv
cancro	../8marzo/post_pref/extraction_corpora/cancro.tsv
colloquio	../8marzo/post_pref/extraction_corpora/colloquio.tsv
coloniale	../8marzo/post_pref/extraction_corpora/coloniale.tsv
commissariamento	../8marzo/post_pref/extraction_corpora/commissariamento.tsv
cubista	../8marzo/post_pref/extraction_corpora/cubista.tsv
embrione	../8marzo/post_pref/extraction_corpora/embrione.tsv
fazioni	../8marzo/post_pref/extraction_corpora/fazioni.tsv
insediamento	../8marzo/post_pref/extraction_corpora/insediamento.tsv
luminescenza	../8marzo/post_pref/extraction_corpora/luminescenza.tsv
mensa	../8marzo/post_pref/extraction_corpora/mensa.tsv
modernista	../8marzo/post_pref/extraction_corpora/modernista.tsv
regolarizzazione	../8marzo/post_pref/extraction_corpora/regolarizzazione.tsv
simbolismo	../8marzo/post_pref/extraction_corpora/simbolismo.tsv
sismìa	../8marzo/post_pref/extraction_corpora/sismìa.tsv
terremoti	../8marzo/post_pref/extraction_corpora/terremoti.tsv
tg	../8marzo/post_pref/extraction_corpora/tg.tsv