esame	../8marzo/pre_pref/extraction_corpora/esame.tsv
impianto	../8marzo/pre_pref/extraction_corpora/impianto.tsv
produzione	../8marzo/pre_pref/extraction_corpora/produzione.tsv
ruolo	../8marzo/pre_pref/extraction_corpora/ruolo.tsv
iscrizione	../8marzo/pre_pref/extraction_corpora/iscrizione.tsv
condizione	../8marzo/pre_pref/extraction_corpora/condizione.tsv
contratto	../8marzo/pre_pref/extraction_corpora/contratto.tsv
contratti	../8marzo/pre_pref/extraction_corpora/contratti.tsv
campionato	../8marzo/pre_pref/extraction_corpora/campionato.tsv
adesione	../8marzo/pre_pref/extraction_corpora/adesione.tsv
embrione	../8marzo/pre_pref/extraction_corpora/embrione.tsv
selezione	../8marzo/pre_pref/extraction_corpora/selezione.tsv
requisiti	../8marzo/pre_pref/extraction_corpora/requisiti.tsv
partita	../8marzo/pre_pref/extraction_corpora/partita.tsv
iscrizioni	../8marzo/pre_pref/extraction_corpora/iscrizioni.tsv
condizioni	../8marzo/pre_pref/extraction_corpora/condizioni.tsv
requisito	../8marzo/pre_pref/extraction_corpora/requisito.tsv
pensionamenti	../8marzo/pre_pref/extraction_corpora/pensionamenti.tsv
apertura	../8marzo/pre_pref/extraction_corpora/apertura.tsv
accordo	../8marzo/pre_pref/extraction_corpora/accordo.tsv
gara	../8marzo/pre_pref/extraction_corpora/gara.tsv
serie	../8marzo/pre_pref/extraction_corpora/serie.tsv
allarme	../8marzo/pre_pref/extraction_corpora/allarme.tsv
intesa	../8marzo/pre_pref/extraction_corpora/intesa.tsv
sequenza	../8marzo/pre_pref/extraction_corpora/sequenza.tsv
pensionamento	../8marzo/pre_pref/extraction_corpora/pensionamento.tsv
scuola	../8marzo/pre_pref/extraction_corpora/scuola.tsv
parco	../8marzo/pre_pref/extraction_corpora/parco.tsv
trattamento	../8marzo/pre_pref/extraction_corpora/trattamento.tsv
test	../8marzo/pre_pref/extraction_corpora/test.tsv
riforma	../8marzo/pre_pref/extraction_corpora/riforma.tsv
registrazione	../8marzo/pre_pref/extraction_corpora/registrazione.tsv
vertice	../8marzo/pre_pref/extraction_corpora/vertice.tsv
crisi	../8marzo/pre_pref/extraction_corpora/crisi.tsv
fattibilità	../8marzo/pre_pref/extraction_corpora/fattibilità.tsv
adolescenti	../8marzo/pre_pref/extraction_corpora/adolescenti.tsv
testo	../8marzo/pre_pref/extraction_corpora/testo.tsv
pagamento	../8marzo/pre_pref/extraction_corpora/pagamento.tsv
morte	../8marzo/pre_pref/extraction_corpora/morte.tsv
eclampsia	../8marzo/pre_pref/extraction_corpora/eclampsia.tsv
conferenza	../8marzo/pre_pref/extraction_corpora/conferenza.tsv
ritiro	../8marzo/pre_pref/extraction_corpora/ritiro.tsv
embrioni	../8marzo/pre_pref/extraction_corpora/embrioni.tsv
post	../8marzo/pre_pref/extraction_corpora/post.tsv
conferenze	../8marzo/pre_pref/extraction_corpora/conferenze.tsv
laurea	../8marzo/pre_pref/extraction_corpora/laurea.tsv
vendita	../8marzo/pre_pref/extraction_corpora/vendita.tsv
emergenza	../8marzo/pre_pref/extraction_corpora/emergenza.tsv
consuntivo	../8marzo/pre_pref/extraction_corpora/consuntivo.tsv
qualificazione	../8marzo/pre_pref/extraction_corpora/qualificazione.tsv
season	../8marzo/pre_pref/extraction_corpora/season.tsv
riserva	../8marzo/pre_pref/extraction_corpora/riserva.tsv
adolescenza	../8marzo/pre_pref/extraction_corpora/adolescenza.tsv
relazione	../8marzo/pre_pref/extraction_corpora/relazione.tsv
partenza	../8marzo/pre_pref/extraction_corpora/partenza.tsv
guerra	../8marzo/pre_pref/extraction_corpora/guerra.tsv
alimentazione	../8marzo/pre_pref/extraction_corpora/alimentazione.tsv
print	../8marzo/pre_pref/extraction_corpora/print.tsv
allerta	../8marzo/pre_pref/extraction_corpora/allerta.tsv
comprensione	../8marzo/pre_pref/extraction_corpora/comprensione.tsv
stagione	../8marzo/pre_pref/extraction_corpora/stagione.tsv
termine	../8marzo/pre_pref/extraction_corpora/termine.tsv
formazione	../8marzo/pre_pref/extraction_corpora/formazione.tsv
dreadnought	../8marzo/pre_pref/extraction_corpora/dreadnought.tsv
ammortamento	../8marzo/pre_pref/extraction_corpora/ammortamento.tsv
conoscenze	../8marzo/pre_pref/extraction_corpora/conoscenze.tsv
serata	../8marzo/pre_pref/extraction_corpora/serata.tsv
Crisi	../8marzo/pre_pref/extraction_corpora/Crisi.tsv
esistenza	../8marzo/pre_pref/extraction_corpora/esistenza.tsv
istruttoria	../8marzo/pre_pref/extraction_corpora/istruttoria.tsv
juniores	../8marzo/pre_pref/extraction_corpora/juniores.tsv
disco	../8marzo/pre_pref/extraction_corpora/disco.tsv
antipasto	../8marzo/pre_pref/extraction_corpora/antipasto.tsv
esercizio	../8marzo/pre_pref/extraction_corpora/esercizio.tsv
consiglio	../8marzo/pre_pref/extraction_corpora/consiglio.tsv
qualifiche	../8marzo/pre_pref/extraction_corpora/qualifiche.tsv
release	../8marzo/pre_pref/extraction_corpora/release.tsv
trapianto	../8marzo/pre_pref/extraction_corpora/trapianto.tsv
euro	../8marzo/pre_pref/extraction_corpora/euro.tsv
selezioni	../8marzo/pre_pref/extraction_corpora/selezioni.tsv
rivoluzione	../8marzo/pre_pref/extraction_corpora/rivoluzione.tsv
tasse	../8marzo/pre_pref/extraction_corpora/tasse.tsv
finale	../8marzo/pre_pref/extraction_corpora/finale.tsv
asta	../8marzo/pre_pref/extraction_corpora/asta.tsv
qualifica	../8marzo/pre_pref/extraction_corpora/qualifica.tsv
stampa	../8marzo/pre_pref/extraction_corpora/stampa.tsv
visione	../8marzo/pre_pref/extraction_corpora/visione.tsv
concetti	../8marzo/pre_pref/extraction_corpora/concetti.tsv
menopausa	../8marzo/pre_pref/extraction_corpora/menopausa.tsv
rilascio	../8marzo/pre_pref/extraction_corpora/rilascio.tsv
cinema	../8marzo/pre_pref/extraction_corpora/cinema.tsv
imposte	../8marzo/pre_pref/extraction_corpora/imposte.tsv
ordine	../8marzo/pre_pref/extraction_corpora/ordine.tsv
volo	../8marzo/pre_pref/extraction_corpora/volo.tsv
valutazione	../8marzo/pre_pref/extraction_corpora/valutazione.tsv
accordi	../8marzo/pre_pref/extraction_corpora/accordi.tsv
boom	../8marzo/pre_pref/extraction_corpora/boom.tsv
lancio	../8marzo/pre_pref/extraction_corpora/lancio.tsv
riscaldamento	../8marzo/pre_pref/extraction_corpora/riscaldamento.tsv
adolescente	../8marzo/pre_pref/extraction_corpora/adolescente.tsv
ascolto	../8marzo/pre_pref/extraction_corpora/ascolto.tsv
elettorale	../8marzo/pre_pref/extraction_corpora/elettorale.tsv
campagna	../8marzo/pre_pref/extraction_corpora/campagna.tsv
corsi	../8marzo/pre_pref/extraction_corpora/corsi.tsv
finanziamento	../8marzo/pre_pref/extraction_corpora/finanziamento.tsv
processore	../8marzo/pre_pref/extraction_corpora/processore.tsv
serale	../8marzo/pre_pref/extraction_corpora/serale.tsv
processing	../8marzo/pre_pref/extraction_corpora/processing.tsv
operatori	../8marzo/pre_pref/extraction_corpora/operatori.tsv
concerto	../8marzo/pre_pref/extraction_corpora/concerto.tsv
elezioni	../8marzo/pre_pref/extraction_corpora/elezioni.tsv
appello	../8marzo/pre_pref/extraction_corpora/appello.tsv
derby	../8marzo/pre_pref/extraction_corpora/derby.tsv
inserimento	../8marzo/pre_pref/extraction_corpora/inserimento.tsv
esposizione	../8marzo/pre_pref/extraction_corpora/esposizione.tsv
elaborazione	../8marzo/pre_pref/extraction_corpora/elaborazione.tsv
regata	../8marzo/pre_pref/extraction_corpora/regata.tsv
Conferenza	../8marzo/pre_pref/extraction_corpora/Conferenza.tsv
colloquio	../8marzo/pre_pref/extraction_corpora/colloquio.tsv
iscritti	../8marzo/pre_pref/extraction_corpora/iscritti.tsv
parto	../8marzo/pre_pref/extraction_corpora/parto.tsv
evoluzione	../8marzo/pre_pref/extraction_corpora/evoluzione.tsv
registrazioni	../8marzo/pre_pref/extraction_corpora/registrazioni.tsv
voto	../8marzo/pre_pref/extraction_corpora/voto.tsv
progetto	../8marzo/pre_pref/extraction_corpora/progetto.tsv
proposta	../8marzo/pre_pref/extraction_corpora/proposta.tsv
screening	../8marzo/pre_pref/extraction_corpora/screening.tsv
lettura	../8marzo/pre_pref/extraction_corpora/lettura.tsv
dinner	../8marzo/pre_pref/extraction_corpora/dinner.tsv
riunione	../8marzo/pre_pref/extraction_corpora/riunione.tsv
intervento	../8marzo/pre_pref/extraction_corpora/intervento.tsv
festival	../8marzo/pre_pref/extraction_corpora/festival.tsv
visualizzazione	../8marzo/pre_pref/extraction_corpora/visualizzazione.tsv
visto	../8marzo/pre_pref/extraction_corpora/visto.tsv
ferie	../8marzo/pre_pref/extraction_corpora/ferie.tsv
modernità	../8marzo/pre_pref/extraction_corpora/modernità.tsv
pensionati	../8marzo/pre_pref/extraction_corpora/pensionati.tsv
show	../8marzo/pre_pref/extraction_corpora/show.tsv
ordini	../8marzo/pre_pref/extraction_corpora/ordini.tsv
corso	../8marzo/pre_pref/extraction_corpora/corso.tsv
inaugurazione	../8marzo/pre_pref/extraction_corpora/inaugurazione.tsv
anestesia	../8marzo/pre_pref/extraction_corpora/anestesia.tsv
negoziato	../8marzo/pre_pref/extraction_corpora/negoziato.tsv
processo	../8marzo/pre_pref/extraction_corpora/processo.tsv
internet	../8marzo/pre_pref/extraction_corpora/internet.tsv
installazione	../8marzo/pre_pref/extraction_corpora/installazione.tsv
adozione	../8marzo/pre_pref/extraction_corpora/adozione.tsv
esami	../8marzo/pre_pref/extraction_corpora/esami.tsv
tattica	../8marzo/pre_pref/extraction_corpora/tattica.tsv
testi	../8marzo/pre_pref/extraction_corpora/testi.tsv
logica	../8marzo/pre_pref/extraction_corpora/logica.tsv
verifica	../8marzo/pre_pref/extraction_corpora/verifica.tsv
crimine	../8marzo/pre_pref/extraction_corpora/crimine.tsv
Crisis	../8marzo/pre_pref/extraction_corpora/Crisis.tsv
avvio	../8marzo/pre_pref/extraction_corpora/avvio.tsv
congresso	../8marzo/pre_pref/extraction_corpora/congresso.tsv
indagine	../8marzo/pre_pref/extraction_corpora/indagine.tsv
order	../8marzo/pre_pref/extraction_corpora/order.tsv
analisi	../8marzo/pre_pref/extraction_corpora/analisi.tsv
mRNA	../8marzo/pre_pref/extraction_corpora/mRNA.tsv
allargamento	../8marzo/pre_pref/extraction_corpora/allargamento.tsv
selection	../8marzo/pre_pref/extraction_corpora/selection.tsv
semina	../8marzo/pre_pref/extraction_corpora/semina.tsv
concepimento	../8marzo/pre_pref/extraction_corpora/concepimento.tsv
scrittura	../8marzo/pre_pref/extraction_corpora/scrittura.tsv
ammissione	../8marzo/pre_pref/extraction_corpora/ammissione.tsv
evangelizzazione	../8marzo/pre_pref/extraction_corpora/evangelizzazione.tsv
aperture	../8marzo/pre_pref/extraction_corpora/aperture.tsv
esistenze	../8marzo/pre_pref/extraction_corpora/esistenze.tsv
riconoscimento	../8marzo/pre_pref/extraction_corpora/riconoscimento.tsv
selezionati	../8marzo/pre_pref/extraction_corpora/selezionati.tsv
comprensioni	../8marzo/pre_pref/extraction_corpora/comprensioni.tsv
convegno	../8marzo/pre_pref/extraction_corpora/convegno.tsv
finali	../8marzo/pre_pref/extraction_corpora/finali.tsv
Parco	../8marzo/pre_pref/extraction_corpora/Parco.tsv
tribolazione	../8marzo/pre_pref/extraction_corpora/tribolazione.tsv
ricovero	../8marzo/pre_pref/extraction_corpora/ricovero.tsv
immatricolazione	../8marzo/pre_pref/extraction_corpora/immatricolazione.tsv
cena	../8marzo/pre_pref/extraction_corpora/cena.tsv
adesioni	../8marzo/pre_pref/extraction_corpora/adesioni.tsv
dessert	../8marzo/pre_pref/extraction_corpora/dessert.tsv
Consiglio	../8marzo/pre_pref/extraction_corpora/Consiglio.tsv
occupazione	../8marzo/pre_pref/extraction_corpora/occupazione.tsv
raffaelliti	../8marzo/pre_pref/extraction_corpora/raffaelliti.tsv
invasione	../8marzo/pre_pref/extraction_corpora/invasione.tsv
consultazione	../8marzo/pre_pref/extraction_corpora/consultazione.tsv
discoteca	../8marzo/pre_pref/extraction_corpora/discoteca.tsv
match	../8marzo/pre_pref/extraction_corpora/match.tsv
potenza	../8marzo/pre_pref/extraction_corpora/potenza.tsv
sentazione	../8marzo/pre_pref/extraction_corpora/sentazione.tsv
acquisto	../8marzo/pre_pref/extraction_corpora/acquisto.tsv
raccolta	../8marzo/pre_pref/extraction_corpora/raccolta.tsv
gravidanza	../8marzo/pre_pref/extraction_corpora/gravidanza.tsv
universitari	../8marzo/pre_pref/extraction_corpora/universitari.tsv
infortunio	../8marzo/pre_pref/extraction_corpora/infortunio.tsv
incontro	../8marzo/pre_pref/extraction_corpora/incontro.tsv
conclave	../8marzo/pre_pref/extraction_corpora/conclave.tsv
inizio	../8marzo/pre_pref/extraction_corpora/inizio.tsv
vita	../8marzo/pre_pref/extraction_corpora/vita.tsv
contenzioso	../8marzo/pre_pref/extraction_corpora/contenzioso.tsv
referendum	../8marzo/pre_pref/extraction_corpora/referendum.tsv
emption	../8marzo/pre_pref/extraction_corpora/emption.tsv
investimento	../8marzo/pre_pref/extraction_corpora/investimento.tsv
obbligo	../8marzo/pre_pref/extraction_corpora/obbligo.tsv
proposte	../8marzo/pre_pref/extraction_corpora/proposte.tsv
restyling	../8marzo/pre_pref/extraction_corpora/restyling.tsv
veggenza	../8marzo/pre_pref/extraction_corpora/veggenza.tsv
matrimonio	../8marzo/pre_pref/extraction_corpora/matrimonio.tsv
recessione	../8marzo/pre_pref/extraction_corpora/recessione.tsv
conference	../8marzo/pre_pref/extraction_corpora/conference.tsv
legge	../8marzo/pre_pref/extraction_corpora/legge.tsv
cog	../8marzo/pre_pref/extraction_corpora/cog.tsv
cristiani	../8marzo/pre_pref/extraction_corpora/cristiani.tsv
elettorali	../8marzo/pre_pref/extraction_corpora/elettorali.tsv
negoziati	../8marzo/pre_pref/extraction_corpora/negoziati.tsv
orientamento	../8marzo/pre_pref/extraction_corpora/orientamento.tsv
posizionamento	../8marzo/pre_pref/extraction_corpora/posizionamento.tsv
marketing	../8marzo/pre_pref/extraction_corpora/marketing.tsv
informazione	../8marzo/pre_pref/extraction_corpora/informazione.tsv
revisione	../8marzo/pre_pref/extraction_corpora/revisione.tsv
assunzione	../8marzo/pre_pref/extraction_corpora/assunzione.tsv
chiusura	../8marzo/pre_pref/extraction_corpora/chiusura.tsv
approvazione	../8marzo/pre_pref/extraction_corpora/approvazione.tsv
concetto	../8marzo/pre_pref/extraction_corpora/concetto.tsv
produzioni	../8marzo/pre_pref/extraction_corpora/produzioni.tsv
camera	../8marzo/pre_pref/extraction_corpora/camera.tsv
missione	../8marzo/pre_pref/extraction_corpora/missione.tsv
fusione	../8marzo/pre_pref/extraction_corpora/fusione.tsv
fase	../8marzo/pre_pref/extraction_corpora/fase.tsv
processamento	../8marzo/pre_pref/extraction_corpora/processamento.tsv
battaglia	../8marzo/pre_pref/extraction_corpora/battaglia.tsv
alpha	../8marzo/pre_pref/extraction_corpora/alpha.tsv
Conferenze	../8marzo/pre_pref/extraction_corpora/Conferenze.tsv
draft	../8marzo/pre_pref/extraction_corpora/draft.tsv
persona	../8marzo/pre_pref/extraction_corpora/persona.tsv
press	../8marzo/pre_pref/extraction_corpora/press.tsv
romana	../8marzo/pre_pref/extraction_corpora/romana.tsv
romanticismo	../8marzo/pre_pref/extraction_corpora/romanticismo.tsv
tangentopoli	../8marzo/pre_pref/extraction_corpora/tangentopoli.tsv
testing	../8marzo/pre_pref/extraction_corpora/testing.tsv
trattativa	../8marzo/pre_pref/extraction_corpora/trattativa.tsv
venzione	../8marzo/pre_pref/extraction_corpora/venzione.tsv
evoluzioni	../8marzo/pre_pref/extraction_corpora/evoluzioni.tsv
caricamento	../8marzo/pre_pref/extraction_corpora/caricamento.tsv
assegnazione	../8marzo/pre_pref/extraction_corpora/assegnazione.tsv
party	../8marzo/pre_pref/extraction_corpora/party.tsv
industrializzazione	../8marzo/pre_pref/extraction_corpora/industrializzazione.tsv
visita	../8marzo/pre_pref/extraction_corpora/visita.tsv
coma	../8marzo/pre_pref/extraction_corpora/coma.tsv
fascismo	../8marzo/pre_pref/extraction_corpora/fascismo.tsv
studio	../8marzo/pre_pref/extraction_corpora/studio.tsv
procedura	../8marzo/pre_pref/extraction_corpora/procedura.tsv
infarto	../8marzo/pre_pref/extraction_corpora/infarto.tsv
CIPE	../8marzo/pre_pref/extraction_corpora/CIPE.tsv
convocati	../8marzo/pre_pref/extraction_corpora/convocati.tsv
crac	../8marzo/pre_pref/extraction_corpora/crac.tsv
dimissioni	../8marzo/pre_pref/extraction_corpora/dimissioni.tsv
domanda	../8marzo/pre_pref/extraction_corpora/domanda.tsv
esistenti	../8marzo/pre_pref/extraction_corpora/esistenti.tsv
espressività	../8marzo/pre_pref/extraction_corpora/espressività.tsv
flash	../8marzo/pre_pref/extraction_corpora/flash.tsv
ira	../8marzo/pre_pref/extraction_corpora/ira.tsv
leggi	../8marzo/pre_pref/extraction_corpora/leggi.tsv
maman	../8marzo/pre_pref/extraction_corpora/maman.tsv
primavera	../8marzo/pre_pref/extraction_corpora/primavera.tsv
scienza	../8marzo/pre_pref/extraction_corpora/scienza.tsv
scissione	../8marzo/pre_pref/extraction_corpora/scissione.tsv
urbanizzazione	../8marzo/pre_pref/extraction_corpora/urbanizzazione.tsv
viste	../8marzo/pre_pref/extraction_corpora/viste.tsv
natale	../8marzo/pre_pref/extraction_corpora/natale.tsv
incubazione	../8marzo/pre_pref/extraction_corpora/incubazione.tsv
fascista	../8marzo/pre_pref/extraction_corpora/fascista.tsv
ingresso	../8marzo/pre_pref/extraction_corpora/ingresso.tsv
mercato	../8marzo/pre_pref/extraction_corpora/mercato.tsv
accoglienza	../8marzo/pre_pref/extraction_corpora/accoglienza.tsv
attivazione	../8marzo/pre_pref/extraction_corpora/attivazione.tsv
nascita	../8marzo/pre_pref/extraction_corpora/nascita.tsv
enfasi	../8marzo/pre_pref/extraction_corpora/enfasi.tsv
eccitazione	../8marzo/pre_pref/extraction_corpora/eccitazione.tsv
vacanze	../8marzo/pre_pref/extraction_corpora/vacanze.tsv
mix	../8marzo/pre_pref/extraction_corpora/mix.tsv
anni	../8marzo/pre_pref/extraction_corpora/anni.tsv
determinazione	../8marzo/pre_pref/extraction_corpora/determinazione.tsv
pensionato	../8marzo/pre_pref/extraction_corpora/pensionato.tsv
moderazione	../8marzo/pre_pref/extraction_corpora/moderazione.tsv
consuntivi	../8marzo/pre_pref/extraction_corpora/consuntivi.tsv
inchiesta	../8marzo/pre_pref/extraction_corpora/inchiesta.tsv
offerte	../8marzo/pre_pref/extraction_corpora/offerte.tsv
accreditamento	../8marzo/pre_pref/extraction_corpora/accreditamento.tsv
alternativa	../8marzo/pre_pref/extraction_corpora/alternativa.tsv
audit	../8marzo/pre_pref/extraction_corpora/audit.tsv
bellici	../8marzo/pre_pref/extraction_corpora/bellici.tsv
colombiano	../8marzo/pre_pref/extraction_corpora/colombiano.tsv
definizione	../8marzo/pre_pref/extraction_corpora/definizione.tsv
destinazione	../8marzo/pre_pref/extraction_corpora/destinazione.tsv
femminista	../8marzo/pre_pref/extraction_corpora/femminista.tsv
home	../8marzo/pre_pref/extraction_corpora/home.tsv
intervista	../8marzo/pre_pref/extraction_corpora/intervista.tsv
macellazione	../8marzo/pre_pref/extraction_corpora/macellazione.tsv
olimpico	../8marzo/pre_pref/extraction_corpora/olimpico.tsv
production	../8marzo/pre_pref/extraction_corpora/production.tsv
pubblicazioni	../8marzo/pre_pref/extraction_corpora/pubblicazioni.tsv
ricerca	../8marzo/pre_pref/extraction_corpora/ricerca.tsv
sales	../8marzo/pre_pref/extraction_corpora/sales.tsv
scoperta	../8marzo/pre_pref/extraction_corpora/scoperta.tsv
stazioni	../8marzo/pre_pref/extraction_corpora/stazioni.tsv
summit	../8marzo/pre_pref/extraction_corpora/summit.tsv
allenamento	../8marzo/pre_pref/extraction_corpora/allenamento.tsv
dissesto	../8marzo/pre_pref/extraction_corpora/dissesto.tsv
evento	../8marzo/pre_pref/extraction_corpora/evento.tsv
amplificatore	../8marzo/pre_pref/extraction_corpora/amplificatore.tsv
terremoto	../8marzo/pre_pref/extraction_corpora/terremoto.tsv
filtraggio	../8marzo/pre_pref/extraction_corpora/filtraggio.tsv
prenotazione	../8marzo/pre_pref/extraction_corpora/prenotazione.tsv
consumo	../8marzo/pre_pref/extraction_corpora/consumo.tsv
compilazione	../8marzo/pre_pref/extraction_corpora/compilazione.tsv
seminario	../8marzo/pre_pref/extraction_corpora/seminario.tsv
uscita	../8marzo/pre_pref/extraction_corpora/uscita.tsv
accettazione	../8marzo/pre_pref/extraction_corpora/accettazione.tsv
conoscenza	../8marzo/pre_pref/extraction_corpora/conoscenza.tsv
digestione	../8marzo/pre_pref/extraction_corpora/digestione.tsv
protostoria	../8marzo/pre_pref/extraction_corpora/protostoria.tsv
malattia	../8marzo/pre_pref/extraction_corpora/malattia.tsv
dimissione	../8marzo/pre_pref/extraction_corpora/dimissione.tsv
alfabetizzazione	../8marzo/pre_pref/extraction_corpora/alfabetizzazione.tsv
cultura	../8marzo/pre_pref/extraction_corpora/cultura.tsv
allertamento	../8marzo/pre_pref/extraction_corpora/allertamento.tsv
assemblea	../8marzo/pre_pref/extraction_corpora/assemblea.tsv
concezioni	../8marzo/pre_pref/extraction_corpora/concezioni.tsv
congedo	../8marzo/pre_pref/extraction_corpora/congedo.tsv
diabetici	../8marzo/pre_pref/extraction_corpora/diabetici.tsv
dichiarazione	../8marzo/pre_pref/extraction_corpora/dichiarazione.tsv
film	../8marzo/pre_pref/extraction_corpora/film.tsv
golpe	../8marzo/pre_pref/extraction_corpora/golpe.tsv
griglia	../8marzo/pre_pref/extraction_corpora/griglia.tsv
incubatore	../8marzo/pre_pref/extraction_corpora/incubatore.tsv
liberalizzazione	../8marzo/pre_pref/extraction_corpora/liberalizzazione.tsv
metro	../8marzo/pre_pref/extraction_corpora/metro.tsv
mutazione	../8marzo/pre_pref/extraction_corpora/mutazione.tsv
parere	../8marzo/pre_pref/extraction_corpora/parere.tsv
pianificazione	../8marzo/pre_pref/extraction_corpora/pianificazione.tsv
professionalizzazione	../8marzo/pre_pref/extraction_corpora/professionalizzazione.tsv
programma	../8marzo/pre_pref/extraction_corpora/programma.tsv
riunificazione	../8marzo/pre_pref/extraction_corpora/riunificazione.tsv
RNA	../8marzo/pre_pref/extraction_corpora/RNA.tsv
sondaggio	../8marzo/pre_pref/extraction_corpora/sondaggio.tsv
stazione	../8marzo/pre_pref/extraction_corpora/stazione.tsv